111111111111
100000000001
10P000000001
100000000001
100000000001
100C0000E001
111111111111