111111111111
10000000C001
10P000000001
10000C000001
100000000001
100C0000E001
111111111111