111111111111
100000000001
10P000001001
100000000001
100C00000001
10000000E001
111111111111