111111111111
100000000001
10P000000001
10000000C001
100C00000001
10000000E001
111111111111