11111111111111111
10000010C00000001
10P00010011000001
10000C10000000001
10000000000100001
100C0000E00000011
11111111111111111