111111111111
100000010001
110000C01001
100000000001
100P00E00001
100001C10101
111111111111